-A="-A"
-B="-B"
-C="-C"
-M="-M"
-O="-O"
-R="-R"
-S="-S"
-T="-T"
-W="-W"
-X="-X"
-B="-b"
-C="-c"
-D="-d"
-E="-e"
-F="-f"
-G="-g"
-K="-k"
-L="-l"
-O="-o"
-P="-p"
-R="-r"
-S="-s"
-T="-t"
-U="-u"
-W="-w"
-X="-x"
-Z="-z"
AUTOLOAD="AUTOLOAD"
BEGIN="BEGIN"
CHECK="CHECK"
DESTROY="DESTROY"
END="END"
INIT="INIT"
UNITCHECK="UNITCHECK"
ABS="abs"
ACCEPT="accept"
ALARM="alarm"
ATAN2="atan2"
BIND="bind"
BINMODE="binmode"
BLESS="bless"
BREAK="break"
CALLER="caller"
CHDIR="chdir"
CHMOD="chmod"
CHOMP="chomp"
CHOP="chop"
CHOWN="chown"
CHR="chr"
CHROOT="chroot"
CLOSE="close"
CLOSEDIR="closedir"
CONNECT="connect"
COS="cos"
CRYPT="crypt"
DBMCLOSE="dbmclose"
DBMOPEN="dbmopen"
DEFINED="defined"
DELETE="delete"
DIE="die"
DUMP="dump"
EACH="each"
ENDGRENT="endgrent"
ENDHOSTENT="endhostent"
ENDNETENT="endnetent"
ENDPROTOENT="endprotoent"
ENDPWENT="endpwent"
ENDSERVENT="endservent"
EOF="eof"
EVAL="eval"
EXEC="exec"
EXISTS="exists"
EXIT="exit"
FCNTL="fcntl"
FILENO="fileno"
FLOCK="flock"
FORK="fork"
FORMAT="format"
FORMLINE="formline"
GETC="getc"
GETGRENT="getgrent"
GETGRGID="getgrgid"
GETGRNAM="getgrnam"
GETHOSTBYADDR="gethostbyaddr"
GETHOSTBYNAME="gethostbyname"
GETHOSTENT="gethostent"
GETLOGIN="getlogin"
GETNETBYADDR="getnetbyaddr"
GETNETBYNAME="getnetbyname"
GETNETENT="getnetent"
GETPEERNAME="getpeername"
GETPGRP="getpgrp"
GETPPID="getppid"
GETPRIORITY="getpriority"
GETPROTOBYNAME="getprotobyname"
GETPROTOBYNUMBER="getprotobynumber"
GETPROTOENT="getprotoent"
GETPWENT="getpwent"
GETPWNAM="getpwnam"
GETPWUID="getpwuid"
GETSERVBYNAME="getservbyname"
GETSERVBYPORT="getservbyport"
GETSERVENT="getservent"
GETSOCKNAME="getsockname"
GETSOCKOPT="getsockopt"
GLOB="glob"
GMTIME="gmtime"
GOTO="goto"
GREP="grep"
HEX="hex"
INDEX="index"
INT="int"
IOCTL="ioctl"
JOIN="join"
KEYS="keys"
KILL="kill"
LAST="last"
LC="lc"
LCFIRST="lcfirst"
LENGTH="length"
LINK="link"
LISTEN="listen"
LOCAL="local"
LOCALTIME="localtime"
LOG="log"
LSTAT="lstat"
MAP="map"
MKDIR="mkdir"
MSGCTL="msgctl"
MSGGET="msgget"
MSGRCV="msgrcv"
MSGSND="msgsnd"
MY="my"
NEXT="next"
NOT="not"
OCT="oct"
OPEN="open"
OPENDIR="opendir"
ORD="ord"
OUR="our"
PACK="pack"
PIPE="pipe"
POP="pop"
POS="pos"
PRINT="print"
PRINTF="printf"
PROTOTYPE="prototype"
PUSH="push"
QUOTEMETA="quotemeta"
RAND="rand"
READ="read"
READDIR="readdir"
READLINE="readline"
READLINK="readlink"
READPIPE="readpipe"
RECV="recv"
REDO="redo"
REF="ref"
RENAME="rename"
REQUIRE="require"
RESET="reset"
RETURN="return"
REVERSE="reverse"
REWINDDIR="rewinddir"
RINDEX="rindex"
RMDIR="rmdir"
SAY="say"
SCALAR="scalar"
SEEK="seek"
SEEKDIR="seekdir"
SELECT="select"
SEMCTL="semctl"
SEMGET="semget"
SEMOP="semop"
SEND="send"
SETGRENT="setgrent"
SETHOSTENT="sethostent"
SETNETENT="setnetent"
SETPGRP="setpgrp"
SETPRIORITY="setpriority"
SETPROTOENT="setprotoent"
SETPWENT="setpwent"
SETSERVENT="setservent"
SETSOCKOPT="setsockopt"
SHIFT="shift"
SHMCTL="shmctl"
SHMGET="shmget"
SHMREAD="shmread"
SHMWRITE="shmwrite"
SHUTDOWN="shutdown"
SIN="sin"
SLEEP="sleep"
SOCKET="socket"
SOCKETPAIR="socketpair"
SORT="sort"
SPLICE="splice"
SPLIT="split"
SPRINTF="sprintf"
SQRT="sqrt"
SRAND="srand"
STAT="stat"
STATE="state"
STUDY="study"
SUBSTR="substr"
SYMLINK="symlink"
SYSCALL="syscall"
SYSOPEN="sysopen"
SYSREAD="sysread"
SYSSEEK="sysseek"
SYSTEM="system"
SYSWRITE="syswrite"
TELL="tell"
TELLDIR="telldir"
TIE="tie"
TIED="tied"
TIME="time"
TIMES="times"
TRUNCATE="truncate"
UC="uc"
UCFIRST="ucfirst"
UMASK="umask"
UNDEF="undef"
UNLINK="unlink"
UNPACK="unpack"
UNSHIFT="unshift"
UNTIE="untie"
USE="use"
UTIME="utime"
VALUES="values"
VEC="vec"
WAIT="wait"
WAITPID="waitpid"
WANTARRAY="wantarray"
WARN="warn"
WRITE="write"
